170
13
13
9
0,0 0,1 0,2 0,3 0,4 1,4 2,4 3,4 4,4 4,5 4,6 4,7 5,7
PBBBBBBBBBBBB
PBBBBBBBBBBBB
PNNNNNNNBBBBB
PNNNNNNNNNBBB
PPPPPBBBBBBBB
BBBBPBBBBBNNN
BBBBPBBBBBBBB
BBBBPPBBBBBNB
BBBBBBBBBBBNB

