170
14
13
9
8,0 8,1 8,2 8,3 8,4 7,4 6,4 6,5 6,6 5,6 4,6 3,6 2,6 1,6 
NNNNNNNBPBBNN
NNNNNNNBPBBNN
NNNNNNNBPBBNN
NNNNNBBBPBBNN
NNNNNBPPPBBNN
BBBBBBPBBBBNN
BPPPPPPBBBBNN
BBBBBBBBBBBNN
NNNNNNNNNNNNN
